_numNPC: 100
####################################################################################################
#...................................................................................................
#.##.###.......###.##.####.#############.#.#.......#########################.......................#
#.##.###.......###.##.####.#############.#.#.......##################............................#.#
#.##.###.......###.##.####.#############.#.#.......#########################################.....#.#
#.....##.......###.##.####.#############.#.#.......########################.........###..........#.#
#.....############.##.##.........#######.#.#.......########################.........###..........#.#
#.....#######....................#######.#.#.......########################.........###..........#.#
#.....#######....................#######.#.#.......########################.........###.....####.#.#
#.....#######....................#######..........................#########.........###.....####.#.#
#.....#######....................#######..........................#########.........###.....####.#.#
#.....#######....................#######..........................#########.........##......####.#.#
#.....#######.#######.##.........####..............................................................#
#......##############.##################..........................#########.........##...........#.#
#########.......#####.##################.#.#.......##############.##########################.....#.#
#.....###############.##.........#######.................................###################.....#.#
#.....###############.##.........#######..........................#######################........#.#
#......##.#.#########.##.........#######..........................#######################........#.#
#......##.#.#########.##.........#######..........................#######################.......##.#
#.......................................................................#################.......##.#
#.####.##.#.#.#######.##.........#######..........................#######################.......##.#
#.####.##.#.#.#######.##.........#######..........................#######################.......##.#
#.####.##.#.#.#######.##.........#######..........................#######################.......##.#
#..................##.##.........#######..........................#######################..........#
#..................##.##..........................................#########.........#####.......##.#
#..................##.##..........................................#########.........##############.#
#......................................................####################.........######.....###.#
#......................................................#################............######.....###.#
#......................................................#################............######.....###.#
#......................................................#################............######.....###.#
#......................................................##########.######............######.....###.#
#......................................................##########.######............######.....###.#
#########.##...........................................##########.######............######.....###.#
#########.##...........................................##########.######.....#############.....###.#
############...........................................##########.##...............................#
############...........................................##########.######.....#############.....###.#
#.##########...........................................##########.######.....#############.....###.#
#.##########...........................................##########.######.....##############.#......#
#.##########...........................................##########.##############...................#
#.##########..#######.###.......########.########################.#########################.######.#
#.##########..#######.###.......########.########################.#########################.######.#
#.##########..#######.###.###.##########.########################.#########################.######.#
#....#######..#######.###.###.##########.########################.######.....###########.........#.#
#..#########..#######.###.###.##########.###############.########.######.....###########.........#.#
#..............##########.###.#####.####.###############.########.######.....###########.........#.#
#..............##########.###.#####.####.###############.########.##.###.....###########.........#.#
#..............##########.###.#####.####.###############.########.##.###.....###########.........#.#
#..............#######...........##.####.......####..................#########.........#.........#.#
#.................####...........##.####.......####..................#########.........#.........#.#
#...........................................................................##.........#.........#.#
#..###............####...........##.####.......####..................#########.........#.........#.#
#..###............####...........##.####.......####..................####..........................#
#..###............####...........##.####.......####.....................######.........#.........#.#
#.####.....#..########...........##.####.......####.....................######.........#.........#.#
#.####.....#..###########.###.#####.####.#############............#.....######.........#.........#.#
#.########.#..###########.###.##########.#############............#.....######.........#.........#.#
#.########.#..###########.###.##########.######...................#.....################.........#.#
#.########.#..###########.###.##########..........................#.....################.........#.#
#.########.#..###########.###.##########.........................................#######.........#.#
#.########.#..#######.......................................................................######.#
#..............##########.###.##########................................################.#########.#
#.....................###.###.##########.......#########.########..#.###################.#########.#
#.########.#..###########.###.##########################.########..#.#########.........#.#########.#
#.########.#..###########.###.##########################.########..#.#.#######.........#.#########.#
#.#####.##.#..###########.#.#.####.#####################.########..#.#.#######.........#.#########.#
#.....................###.#.#.####.######.....##########.########.......######.........#.#########.#
#.....................###.#.#.####.######.....##########.########.......######.........#.#########.#
#.....................###.#.#.####.######.....##########.########.......################.#########.#
#.....................#####.#.####.######.....##########.########.......################.#########.#
#.....................#####.#.####.######.....##########.########.......################.#########.#
#.########.##.#############.#.####.#####################.#########.#...#################.#########.#
#.########.............................................................#################.#########.#
#.########.............................................................#################.#########.#
#....#####.............................................................###########################.#
#......###.............................................................###########################.#
#.########.............................................................###########################.#
#.########.##.####.......##.#.####.###############.###############.##..###########################.#
#.########.##.####.......##.#.####.###############.###############.##..###########################.#
#.########.##.####.......##.#.####.###############.###############.##..###################.......#.#
#.########.##.#############.#.####.###############.#####.#########.##..###################.......#.#
#.....####.#######.......##.#.####.###############.#####.#########.##..###################.......#.#
#.....####.#######.......##.#.####.##############.........####...............############..........#
#.....####.#######.......##.#.####.######...............................#################..........#
#.....####.#######.......##.#.####.###############.#####.##.######.##..###################.......#.#
#.....############.......##.#.####.##...............####.#########.##..###################.......#.#
#.###...........##.......##.#.####.......................#########.##..###########################.#
#...............##.......##.#.####.###############.....#.#########.##..###########################.#
#.###....................##.#.####.###############.#####.#########.##..###########################.#
#.###...........##.......##.#.####.###############.###.............................###############.#
#.###..............................................................##..###########################.#
#.###..............................................................##..########.##################.#
#.###..............................................................##..########.##################.#
#.############.....................................................##..########.################...#
#..................................................................##..########.##################.#
#.................######.#..#.##.........###..............########.##..########.##################.#
#.................######.#..#.##.................................................#################.#
#...........................................................................................###.##.#
#.................#......................###..............########.###.########.###############.##.#
#..@................................................................................................#
####################################################################...................###########.#
