_numNPC: 100
####################################################################################################
#......................############.#####.......................................##################.#
#......#####.#####..##.############.#####.......................................##################.#
#........................##########.#####.......................................##################.#
#........................##########.#####.......................................##################.#
#.........................#########.#####.......................................##################.#
#........................##########.#####.......................................##################.#
#........................##########.#####################..#.###.#########.#######################.#
#........................##########.#####################..#.###.########################.########.#
#..........................................................................##############.########.#
#..........................................................................##############.########.#
#..........................................................................##############.########.#
#..........................................................................##############.########.#
#..........................................................................##############.########.#
#........................###########.......##############..#.###.########################.########.#
#...............##.###.##################################..#.###.########################.########.#
#......................##################################..#.###.########################.########.#
#....................#....................................................###############.########.#
#....................#....................................................###############.########.#
#....................#....................................................###############.########.#
#....................#....................................................###############.########.#
#....................#....................................................########################.#
#....................#....................................................########################.#
#...............##.###....................................................########################.#
#...............##.###.##############.###################..#####.#################.........#######.#
#...............##.###.##############.###################..#####.#############.............##......#
#...............##.###.##############.#####...............................####.............##......#
#...............##.###.##############.###################..#####.#############.............##......#
#...............##.###.##############.###################..#####.#############.............##......#
#...............##..........................................................##.............##......#
#...............##.###.##############.###################..#####.#############.............##......#
#...............##.###.##############.#########............................................##......#
#...............##.###.##############.###################..#####..################.........#######.#
#...............##.###.##############.###################..#####..################################.#
#......................................................................................###########.#
#....................................................####..#####..##################...........###.#
#....................................................####..#####..##################...........###.#
#.................................................................##################...........###.#
#....................................................####..#####..##################...........###.#
#....................................................####..#####..##################............##.#
#.........................####...................########..#####..#######################.......##.#
#.........................###########.###################..#####..#######################.......##.#
#..................................................................................................#
#................................####.###################..#####..#######################.......##.#
#.........................###########.###################..#####..#######################.......##.#
#.....................................................................###################.......##.#
#.....................................................................###################.......##.#
#######...............................................................###################.......##.#
#######...............................................................###################.......##.#
#######.........##.###.##.............................................###################.......##.#
#######.........##.###.##############.##.################..#####..###.##################...........#
#######.........##.###.##############.##.################.######..###.###################.......##.#
##########.#######.###.##############.##.################.######..###.###################.......##.#
##########.#######.###.##############.##.########.....................###################.......##.#
##########.#######.###.#################.########.....................#####################.######.#
##########.#######.###.############.........#####.....................#####################.######.#
##########.#######.###.############.........#####.....................#####################.######.#
##########.#######.###.####.#######.........#####.....................#####################.######.#
##########.#######.###.####.#######.........#############.######.####.#####################.######.#
##########.#######.###.####.#######.........###########..........####.#####################.######.#
##########.#####.........##.#######.........###########.....................###############.######.#
##########.#####.........##.#######..................##.....................###############.######.#
##########.#####.........##.#######..................##.....................###############.######.#
##########.#####.........##.#######..................##...............................#####.######.#
##########.#####.........##.#######..................##...............................#####.######.#
##########.#####.........##.#######..................##...............................#####.######.#
##########.#####.........##########.####.#...........####.######......................#####.######.#
##########.###########.############.####.#...........####.######.####.#####...........##.........#.#
#########..#####.........##########.####.#...........####.######.####.#####...........##.........#.#
#########..#####.........#...######.####.#...........####.######.####.#####...........##.........#.#
#########..#####.........##########.####.#...........####.######.####.##################.........#.#
#########..#####........................................................################.........#.#
#########..#####........................................................###################.######.#
###.................................................................................................
#########..########.....................................................###################.######.#
#########..########.....................................................###################.######.#
#########..########.....................................................###################.######.#
#########..########.....................................................##...............##.######.#
#########................................................................................##........#
#########..##########...........###..........................###.####.####...............##........#
#########..##########...........###..........................###.####.#..................##........#
#########..########.............###..........................###.####.#..................##........#
#########..########.............###..........................###.####.#..................##........#
#########..########.............###..........................###.####.#..................##........#
#######.........###.............###...............######..######.####.#..................##........#
#######.........###.....###########.####..........######..######.####.####...............##.####.#.#
#######.........###.....###########...............######..######.####.#####################.####.#.#
#######.....................................................####.####.###############..............#
#######.........###.....###########......##.####.##.........##........#####################.####.#.#
#.......................###########......##.####.##.........##........#######.##################.#.#
#######.........###.....###########......##.####.##.........##........#######.##################.#.#
#########..########..............##......##.####.##.........##........#######.##################.#.#
#########..########..............##......##..........###.#####........#######.##################.#.#
#######..........................##......##.####.###.###.############.#######.##################.#.#
#................................##......##.####.###.###.############.#######.##################.#.#
#######.........####.............##.####.##.####.###.###.############.#######.##################.#.#
#######.........######.######.#####.####.##.####.###.###.############.#######.##################.#.#
#######.........######.######.#####.####.##.####.###.###.#################.......###############.#.#
#...................................................................................................
########################################.................#########################################.#
