_numNPC: 100
####################################################################################################
######.......................................................................................#####.#
######.....................................................................########.##############.#
######.....................................................................########.##############.#
#...................................................................................##############.#
#...................................................................................##############.#
#.....................########......................................................##############.#
#.....................#########..##......######...........#############.#...........##############.#
#.....................##########.##......######...........#############.#...........##############.#
#.....................##########.##......######...........#############.#...........##############.#
#.....................##########.#.......######...........#############.#...........##############.#
#.....................##########.##......######...........#############.#...........###.....######.#
#.....................##.#######.##.#.##.######...........#############.#...........###.....######.#
#.....................##.##.####.##.#.##.######..............##########.#...........###.....######.#
#.....................#.......#######.##.######...........#############.#...........###.....######.#
#.....................#.......#######.##.######...........#############.#...........###.....######.#
#.............................#######.##...........................................................#
#.....................#.......#######.##.##.###...........#############.#...........###.##########.#
#.........................................................#############.#...........###.##########.#
#.....................##.##.#########.##.##.###...........#############.#...........###.##########.#
#..............................................................................................###.#
#.....................##.##.##..........................................#...........###.#.########.#
#.....................##.##.##..........................................#...........###.#.########.#
#.....................##.##.##..........................................##.########.###.#.########.#
#.......................................................................##.########.###.#.########.#
#.......................................................................##.########.###.#.########.#
#.......................................................................##.########.###.#.########.#
#.......................................................................##.########.#.#.#.########.#
#.......................................................................##.########.#.#.#.########.#
#.....................################....................#############.##.########.#.#.#.########.#
#.....##.####.#.......################........................................#####.#............#.#
#.....##.####.#.......################........................................#####.#.#.#.########.#
#.....##.####.#.......######..................................................#####.#.#.#.########.#
#.....##.####.#.......################........................................#####.#.#.#.########.#
#.....##.####.#...................####........................................#####.#.#.#.########.#
#.....##.####.#...................####....................###########...........###.#.#.#.########..
#.....##.####.#...................####....................###########.....................########..
#.....##.####.#...................####..............................................................
#.....##.####.#...........................................#.......###.....................#####.....
#.....##.####.#........#########..........................#.......###.....................########..
#.....##.####.#...............##..........................#.......###.....................########..
#.....##.####.########........##..........................#.......###.....................########..
#.....##.####.########........##..........................###########.....####............########.#
#.....##.####.########........##..........................###########.....#########.#.#.#.########.#
#.....##.####.########........##..........................#############.###########.#.#.#.########.#
#.....##.####.########.#########..........................#############.###########.#.#.#..#######.#
#.....##.####.########.######.##..........................#############.###########.#.#.#..#######.#
#.....##.####.########.######.########....................############.....######..........#######.#
#.....##.####.########.######.########....................############.....##..............#######.#
#.....##.####.########.######.########..............................##.....##..............######..#
#.....##.####.########.######.########..............................##.....##..............######..#
#.....##.####.########.######.########..............................##.....##..............######..#
#.....##.####.#####...............####..............................##.....##......................#
#.....##.####.#####...............####..............................##.....##..............######..#
#.....##.####.#####...............####....................############.....##..............######...
#.....##.####.#####...............####....................############.....######..........######...
#.....##.####.#####...............####....................#########################.#####..#######..
#.....##.####.########.######.########....................#########################.#####..#######..
#.....##.####.########...............#....................##############...............##..#######..
#......#.####.#######...........######..............................................................
#.....##.####.#######...........######.........#########################...............##.########..
########.####.#######...........######.........####################....................##.########..
#######.......###...................................................................................
#######.......#######...........######.........############.......#.................................
#######.............................##.........############.......#.................................
#######.......#######...........######.........############.......#.......#########.#####.########..
#######.......#######...........######.........############.......#.......#########.#####.########..
#######.......##....................................................................................
#######.......#######...........######.........############.......#.................................
#######.......#######...........##########............................................###.########..
#######.......#######...........###########################.......#...................###.########..
#######.......#######...........###########################.......#...................###.########..
#######.......#######...........#########################################.............###.########..
#######.......#######...........#########################################.............###.########..
#######.......#######...........#########################################.............###.########..
########.####.#######...........###################################################.#####.########..
########.####.#######...........############################........................................
########.####.#######...........###################################################.#####.########..
########.####.########.#.#################################........................#.#####.########..
########.####.########.#.#########################...........................................#####..
########.####.########.#.#################################........................#.#####.########..
########.####.########.#.#################################........................#######.########..
########.####.########.#.############################.........................................####..
########.####.########.#.################################################################.########..
########.####.########.#.################################################################.########..
########.####.########.#.############################################.#######.###########.########..
########.####.########.#.#################################.........................######.########..
########.####.########.#.#################################.........................######.########..
########.####.########.#.#################################.........................######.########..
########.####.########.#.#################################.........................######.########..
######.........#######.###################################.........................######.###.......
######.........#######.###################################.........................######.########..
######.........#######.###################################.........................######.########..
######.........#######.###################################.........................######.########..
######.........#######.###################################.........................######.########..
######.........#######.###################################......................................##..
######.........#######.###################################.........................######.########..
########.####.########.##########################################.#######################.########.#
###................................................................................................#
####################################################################################################
