²²²²²²²²²²²²²²²²²²²²²²²²²²²²²²²²²²²²²²²²²²²²²²²²²²²²²²²²²²²²²²²²²²²²²²²²²²²²²²²²²²²²²²²²²²²²²²²²²²²²
²                           ²²²²²²²²²² ²²²²²                                                       ²
² ²² ²²² ²²²²²²²²²²²²²²²²²²²²²²²²²²²²² ²²²²²²²               ²²         ²²² ²²²²²²²²²²²²²²²²²²²² ² ²
² ²² ²²² ²²²²²²²²²²²²²²²²²²²²²²²²²²²²² ²²²²²²²               ²²         ²²² ²²²²²²²²²²²²²²²²²²²² ² ²
²²²² ²²² ²²²²²²²²²²²²²²²²²²²²²²²²²²²²² ²²²²²²²               ²²         ²²² ²²²²²²²²²²²²²²²²²²²² ² ²
²²²² ²²² ²²²²²²²²²²²²²²²²²²²²²²²²²²²²² ²²²²²²²               ²²                ²²²²²²²²²²²²²²²²² ² ²
²²²²²²²² ²²²²²²²²²²²²²²²²²²²²²²²²²²²²² ²²²²²²²       ²²²²²²² ²²                ²²²²²²²²²²²²²²²²² ² ²
²²²²²²²² ²²²²²²²²²²²²²²²²²²²²²²²²²²²²² ²²²²²²²²²²²²²²²²²²²²² ²²                ²²²²²²²²²²²²²²²²² ² ²
²²²²²²²² ²²²²²²²²²²²²²²²²²²²²²²²²²²²²² ²²²²²²²²²²²²²         ²²²²² ² ²²²       ²²²²²²²²²²          ²
²   ²²²² ²²²²²²²²²²²²²²²²²²²²²²²²²²²²² ²²²²²²²²²²²²²         ²²²²² ²²²²²       ²²²²²²²²²²          ²
²²²²²²²² ²²²²²²²²²²²²²²²²²²²²²²²²²²²²² ²²²²²²²²²²²²²         ²²²²² ²²²²²       ²²²²²²²²²²          ²
² ²²²²²² ²²²²²²²²²²²²²²²²²²²²²²²²²²²²² ²²²²²²²²²²²²²         ²²²²² ²²²²²       ²²²²²²²²²           ²
² ²²²²²² ²²²²²²²²²²²²²²²²²²²²²²²²²²²             ²²²         ²²²²² ²²²²²       ²²²²²²²²²²          ²
²                    ²²²²²²²²²²²²²²²             ²²²         ²²²²² ²²²²²       ²²²²²²²²²²          ²
²                    ²²²²²²²²²²²²²²²             ²²²         ²²²²² ²²²²²       ²²²²²²²²²²          ²
²                    ²²²²²²²²²²²²²²²             ²²²         ²²²²² ²²²²²       ²²²²²²²²²²²²²²²²² ² ²
²                    ²²²²²²²²²²²²²²²             ²²²         ²²²²² ²²²²²       ²²²²²²²²²²²²²²²²² ² ²
²                                                                     ²²       ²²²²²²²²²²²²²²²²² ² ²
² ²²²²²²²²²²²²²²²²²²²²²²²²²²²²²²²²²²             ²²²²        ²²²²² ²²²²²       ²²²²²²²²²²²²²²²²² ² ²
² ²²²²²²²²²²²²²²²²²²²²²²²²²²²²²²²²²²²² ²²²²²²²²²²²²²²        ²²²²² ²²²²²       ²²²²²²²²²²²²²²²²² ² ²
² ²²²²²²²²²²²²²²²²²²²²²²²²²²²²²²²²²²²² ²²²²²²²²²²²²²²        ²²²²² ²²²²²       ²²²²²²²²²²²²²²²²² ² ²
² ²²         ²²²                             ²²²²²²²²       ²²²²²²²²²²²²       ²²²²²²²²²²²²²²²²² ² ²
²                                            ²²²²²²²        ²²²²²²²²²²²²²²² ²²²²²²²²²²²²²²²²²²²² ² ²
² ²²         ²²²                                            ²²²²²²²²²²²²²²² ²²²²²²²²²²²²²²²²²²²² ² ²
² ²²         ²²²                             ²²²²²²²²       ²²²²²²²²²²²²²²² ²²²²²²²²²²²²²²       ² ²
²  ²         ²²²                             ²²²²²²²²       ²²²²²²²²²²²²²²² ²²²²²²²²²²²²²²       ² ²
²                            ²²²²² ²²² ²²²²²²²²²²²²²²       ²²²²²²²²²²²²²²² ²²²²²²²²²²²²²²       ² ²
²                            ²²²²² ² ² ²²²²²²²²²²²²²²       ²²²²²²²²²²²²²²² ²²²²²²²²²²²²²²       ² ²
²                            ²²²²² ² ² ²²²²²²²²²²²²²²       ²²²²²²²²²²²²²²²²²²²²²²²²²²²²²²       ² ²
²                            ²²²²² ² ² ²²²²²²²²²²²²²²       ²²²²²²²²²²²²²²²²²²²²²²²²²²²²²²       ² ²
²                            ²²²²² ² ² ²²²²²²²²²²²²²²       ²²²²²²²²²²²²²²²²²²²²²²²²²²²²²²       ² ²
²                                          ²²²²²²²²²²       ²²²²²²²²²²²²²²²²²²²²²²²²²²²²²²       ² ²
²              ²²²                         ²²²²²²²²²²²² ²²²²²²²²²²²²²²²²²²²²²²²²²²²²²²²²²²       ² ²
²              ²²²                         ²²²²²²²²²²²²²²²²²²²²²²²²²²²²²²²²²²²²²²²²²²²²²²²       ² ²
²              ²²²                         ²²²²²²²²²²²²²²²²²²²²²²²²²²²²²²²²²²²²²²²²²²²²²²²       ² ²
²              ²²²                         ²²²²²²²²²²²²²²²²²²²²²²²²²²²²²       ²²²²²²²²²²²       ² ²
²              ²²²                         ²²²²²²²²²²²²²²²²²²²²²²²²²²²²²       ²²²²²²²²²²²       ² ²
²              ²²²                         ²²²²²²²²²²²²²²²²²²²²²²²²²²²²²       ²²²²²²²²²²²       ² ²
²     ²²²² ²       ²²²²²²²²² ²²²²² ²²² ²²²²²²²²²²²²²²²²²²²²²²²²²²²²²²²²²       ²²²²²²²²²²²       ² ²
² ²²²²²²²² ²       ²²²²²²²²² ²²²²² ²²² ²²²²²²²²²²²²²²²²²²²²²²²²²²²²²²²²²       ²²²²²²²²²²²       ² ²
² ²²²²²²²² ²       ²²²²²²²²² ²²²²² ²²² ²²²²²²²²²²²²²                             ²²²²²²²²²       ² ²
²        ² ²       ²²²²²²²²² ²²²²² ²²² ²²²²²²²²²²²²²²       ²²²²²²²²²²²²       ²²²²²²²²²²²²²²²²²²² ²
²        ² ²       ²²²²²²²²² ²²²²² ²²² ²²²²²²²²²²²²²²       ²²²²²²²²²²²²²²²²²²²²²²²²²²²²²²²²²²²²²² ²
²        ² ²       ²²²²²²²²² ²²²²² ²²² ²²²²²²²²²²²²²²       ²²²²²²²²²²²²²²²²²²²²²²²²²²²²²²²²²²²²²² ²
²                  ²²²²²²²²² ²²²²² ²²² ²²²²²²²²²²²²²²       ²²²²²²²²²²²²       ²²²²²²²²²²²²²²²²²²² ²
²        ² ²       ²²²²²²²²² ²²²²² ²²² ²²²²²²²²²²²²²²       ²²²²²²²²²²²²       ²²²²²²           ²² ²
² ²²²²²²²² ²       ²²²²²²² ² ²²²²² ²²² ²²²²²²²²²²²²²²²²²²²²²²²²²²²²²²²²²       ²²²²²²           ²² ²
² ²               ²²²²²²²² ² ²²²²² ²²² ²²²²²²²²²²²²²²²²²²²²²²²²²²²²²²²²²       ²²²²²²           ²² ²
²                                        ²²²²²²²²²²²²²²²²²²²²²²²²²²²²²²²       ²²²²²²           ²² ²
²                                       ²²²²²²²²²²²²²²²²²²²²²²²²²²²²²²²²²²²²²²²²²²²²²           ²² ²
²                                       ²²²²²²²²²²²²²²²²²²²²²²²²²²²²²²²²²²²²²²²²²²²²²           ²² ²
²                                       ²²²²²²²²²²²²²²²²²²²²²²²²²²²²²²²²²²²²²²²²²²²²²           ²² ²
²                                       ²²²²²²²²²²²²²²²²²²²²²²²²²²²²²²²²²²²²²²²²²²²²²           ²² ²
²                                       ²²²²²²²²²²²²²²²²²²²²²²²²²²²²²²²²²²²²²²²²²²²²²           ²² ²
²                                       ²²²²²²²²²²²²²²²²²²²²²²²²²²²²²²²²²²²²²²²²²²²²²           ²² ²
²                                       ²²²²²²²²²²²²²²²²²²²²                                    ²² ²
²²²²²²²²²²²²²²²²²²²²²²² ²² ²²²²²²²²²²² ²²²²²²²²²²²²²²²²²²²²²²²²²²²²²²²²²²²²²²²²²²²²²²²²²²²²²²²²²²² ²
²²²²²²²²²²²²²²²²²²²²²²² ²² ²²²²²²²²²²² ²²²²²²²²²²²²²²²²²²²²²²²²²²²²²²²²²²²²²²²²²²²²²²²²²²²²²²²²²²² ²
² ²²²²²²²²²²²²²²²²²²²²² ²² ²²²²²²²²²²² ²²²²²²²²²²²²²²²²²²²²²²²²                            ²²²²²²² ²
²                                  ²²² ²²²²²²²²²²²²²²²²²²²²²²²²                            ²²²²²²² ²
²                                  ²²² ²²²²²²²²²²²²²²²²²²²²²²²²                            ²²      ²
²                                  ²²² ²²²²²²²²²²²²²²²²²²²²²²²²                            ²²²²²²² ²
²                                  ²²² ²²²²²²²²²²²²²²²²²²²²²²²²                            ²²²²²²² ²
²                                      ²²²²²²²²²²²²²²²²²²²²²²²²                            ²²²²²²² ²
² ²²²²²²²²²²²²²²²²²²       ²²²²²²²²²²² ²²²²²²²²²²²²²²²²²²²²²²²²                            ²²²²²²² ²
² ²²²²²²²                                                             ²²²²² ²²²²²²²²²²²²²²²²²²²²²² ²
² ²²²²²²²                                                             ²²²²² ²²²²²²²²²²²²²²²²²²²²²² ²
² ²²²²²²²                                                             ²²²²² ²²²²²²²²²²²²²²²²²²²²²² ²
² ²² ²²²²                                                             ²²²²² ²²²²²²²²²²²²²²²²²²²²²² ²
² ²² ²²²²                                                             ²²²²² ²²²²²²²²²²²²²²²²²²²²²² ²
² ²² ²²²²                                                             ²²²²² ²²²²²²²²²²²²²²²²²²²²²² ²
²                                                                     ²²²²² ²²²²²²²²²²²²²²²²²²²²²² ²
²                                                                 ²²²²²²²²² ²²²²²²²²²²²²²²²²²²²²²² ²
²                                                                  ²²²²²²²² ²²²²²²²²²²²²²²²²²²²²²² ²
²                                                                  ²²²                             ²
²                                                                           ²²²²²²²²²²²²²²²²²²²²²² ²
²                                                                  ²²²²²²²² ²²²²²²²²²²²²²²²²²²²²²² ²
²                                                                  ²²²²²²²² ²²²²²²²²²²²²²²²²²²²²²² ²
²                                                             ²²²²²²²²²²²²² ²²²²²²²²²²²²²²²²²²²²²² ²
²                                                             ²²²²²²²²²²²²² ²²²²²²²²²²²²²²²²²²²²²² ²
²                                                                           ²²²²²²²²²²²²²²²²²²²²²² ²
²          