_numNPC: 100
####################################################################################################
#.######.............#################.............................................................#
#..........#.#.....#####################.####.....##############.....................#############.#
#.##########.#.....#####################.####.....##############.....................#############.#
#.########.........................#####.####.....##############.....................#############.#
#.########.........................#####.####.....##############.....................#############.#
##########.........................#####.####.....##############.....................#############.#
########...........................#####.####............##########################.##############.#
##########.........................#####.#########.......##########################.##############.#
##########...............................#######.#.......##################.#######.##############.#
#.########...............................#######.#.......##########...............#.##############.#
############.##.##############...........#######.#.......##########...............#.##############.#
#.....######.##.##############...........#######.##################...............#.##############.#
#......................#######...........#######.##################...............#.##############.#
#......................#######...............................######...............#.###.##########.#
#......................#######.................................................................###.#
#......................#######...............................######............................###.#
#......................#######...............................######............................###.#
#.....######.##.##############...............................######............................###.#
#........###.##.##############........................##.......................................###.#
#........###.##.##############........................##..........................#.###.###...####.#
#........###.##.##############........................##...........###.............................#
#........###.##.##################.#.###..............##...........###############.............###.#
#........###.##.##################.#.###..............##...........##..........................###.#
#........###.##.##################.#.###..............##...........##...........##.............###.#
#........###.##.##################.#.###..............##...........##...........##.............###.#
#.##########.##.##################.#.###.############################...........##.............###.#
#.##########.##.##############...........############################...........##.............###.#
#.##########.##.##############...........##############............................................#
#.##########.##.##############...........###############.############...........###.###.####..####.#
#.....................##............................................#...........###.#.........####.#
#.....................########...........#...........###............#...........###.#........#####.#
#.....................########...........#...........###............###.###########.#........#####.#
#.....................########...........#...........###............###.###########.#........#####.#
#.....................#..................#...........###............###.###########.#........#####.#
#..................####..................#...........###............###.###########.###.####.#####.#
#..................####..................#...........###............###.###########.##.....#.#####.#
##.................####..................#...........###.##############.####.........#.............#
##.................####.........#..#.#.#################.##############.####.........#.............#
##.................##############..#.#.#################.##############.####.........#.............#
############.##########.....................############.###################.......................#
############.####################............................###############.........#.............#
############.####################............................#########################.....#######.#
############.####################............................##########################.##.#######.#
#.......................#########............................##########################.##.#######.#
#.......................##########...........................##########################.##.#######.#
#.......................##########.#.#.##.#.....................#######################.##.#######.#
#.......................##########.#.#.##.#.......######.##############.###############.##.#######.#
#...............................##.#.#.##.#.......######.##############.#.#####....................#
#.##########.####..........................................................############.##.##......#
############.####..........................................................############.##.##......#
############.####..........................................................###########..##.##......#
#..........................................................................###########..##.##......#
############.####..........................................................###########..##.##......#
#.##########.####...............##.#..............######.##############.##############..##.##......#
#.............######.########.####.#..............######.##############.##############.###.##......#
#.##########.#######.########.####.#.........###########.##############.######.....................#
#.##########.##...............####.#.......#############.##############.##############.###.#######.#
#..#########.#######..........####.#.......#############.##############.##############.###########.#
#.##########.#######..........####.#...............................####.##############.###########.#
############.#######..........##.#.#...............................#########.............#########.#
#..........#.##....................................................................................#
#..........#.#######..........##.#.#.#.#...........................#########.............####......#
#.............................##.#.#.#.#...........................................................#
#..........#.#######..........##.#.#.#.##.###########.##.###################.............####......#
#..........#.#######..........##.#.#.#.##.###########.##.###########.......###########.######......#
#..........#.#######.........###..........................................############.######......#
#..........#.#######.........###..........................................############.######......#
#..........#.#######.#####.#####..........................................############.######......#
#.................................................................................####.######......#
#.##########.#######.#####.#####..........................................############.######......#
#.##########.#######.#####.#####..........................................############.######......#
#.##########.#.......#####.#####...................................................................#
#.###................#####.#####..........................................############.###########.#
#.........................................................................#.........................
#....................#####................................................############.###########.#
#....................#####.#####...................................................................#
#................###.#####.###.......#.##############.##.####..#######################.###########.#
#.....######.#######.#####.###.....................................................................#
#...........................................................................................######.#
#.....######.#######.#####.##................................................#########.###########.#
#...............####.#####.##................................................#########.###########.#
#...............####.#####.##................................................#########.###########.#
#.#.............####.#####.##................................................#########.###########.#
#.#.............####.#####.##................................................#########.###########.#
#.#.............####.#####.##................................................####.####.###########.#
#.##########.#######.#####.##................................................####.####.###########.#
#.#######.##.#######.#####.##.##.#.#.......##########.##.####.##..........................########.#
#.....................####.##.##.###.......#############.####.##..........................########.#
#.....................####.##.##.###.#.............................................................#
#....................................###################.####.##..........................##########
#.....................####.##.##.###.###################.####.##..........................##########
#.....................####.##.#..........................####.##..........................##########
#.....................####.##.#..........................####.##..........................##########
#.....................####.##.#..........................#######..........................##########
#......##.##.#######.#####.##.#..........................#######..........................##########
#.#######.##.#######.#####...............................#######.#####################.#############
#.#######.##.#######.#####.##.######.###################.#######.#####################.#############
#..@................................................................................................#
######################################################################################.#############
